0011111111111111111111111111111111111111111111111111111115111111111111111111111111111111111111111111111111111111100/
0011111111111111111111111111111111111111111111111111111115111111111111111111111111111111111111111111111111111111100/
0011111111111111111111111111111111111111111111111111111115111111111111111111111111111111111111111111111111111111100/
0011111111111111111111111111111111111111111111111111111111111111111111111111111111111111111111111111111111111111100/
0011111111111111111111111111111111111111111111111111111115111111111111111111111111111111111111111111111111111111100/
0011111111111111111111111111111111111111111111111111111115111111111111111111111111111111111111111111111111111111100/
0011111111111111111111111111111111111111111111111111111115111111111111111111111111111111111111111111111111111111100/
0011111111111111111111111111111111111111111111111111111111111111111111111111111111111111111111111111111111111111100/
0011111111111111111111111111111111111111111111111111111115111111111111111111111111111111111111111111111111111111100/
0011111111111111111111111111111111111111111111111111111115111111111111111111111111111111111111111111111111111111100/
0011111111111111111111111111111111111111111111111111111115111111111111111111111111111111111111111111111111111111100/
0011111111111111111111111111111111111111111111111111111111111111111111111111111111111111111111111111111111111111100/
0011111111111111111111111111111111111111111111111111111115111111111111111111111111111111111111111111111111111111100/
0011111111111111111111111111111111111111111111111111111115111111111111111111111111111111111111111111111111111111100/
0011111111111111111111111111111111111111111111111111111115111111111111111111111111111111111111111111111111111111100/
0011111111111111111111111111111111111111111111111111111111111111111111111111111111111111111111111111111111111111100/
0011111111111111111111111111111111111111111111111111111115111111111111111111111111111111111111111111111111111111100/
0011111111111111111111111111111111111111111111111111111115111111111111111111111111111111111111111111111111111111100/
0011111111111111111111111111111111111111111111111111111115111111111111111111111111111111111111111111111111111111100/
0011111111111111111111111111111111111111111111111111111111111111111111111111111111111111111111111111111111111111100/
0011111111111111111111111111111111111111111111111111111115111111111111111111111111111111111111111111111111111111100/
0011111111111111111111111111111111111111111111111111111115111111111111111111111111111111111111111111111111111111100/
0011111111111111111111111111111111111111111111111111111115111111111111111111111111111111111111111111111111111111100/
0011111111111111111111111111111111111111111111111111111111111111111111111111111111111111111111111111111111111111100/
0011111111111111111111111111111111111111111111111111111115111111111111111111111111111111111111111111111111111111100/
0011111111111111111111111111111111111111111111111111111115111111111111111111111111111111111111111111111111111111100/
0011111111111111111111111111111111111111111111111111111115111111111111111111111111111111111111111111111111111111100/
0011111111111111111111111111111111111111111111111111111111111111111111111111111111111111111111111111111111111111100/
0011111111111111111111111111111111111111111111111111111115111111111111111111111111111111111111111111111111111111100/
0011111111111111111111111111111111111111111111111111111115111111111111111111111111111111111111111111111111111111100/
0011111111111111111111111111111111111111111111111111111115111111111111111111111111111111111111111111111111111111100/
0011111111111111111111111111111111111111111111111111111111111111111111111111111111111111111111111111111111111111100/
0011111111111111111111111111111111111111111111111111111115111111111111111111111111111111111111111111111111111111100/
0011111111111111111111111111111111111111111111111111111115111111111111111111111111111111111111111111111111111111100/
0011111111111111111111111111111111111111111111111111111115111111111111111111111111111111111111111111111111111111100/
0011111111111111111111111111111111111111111111111111111111111111111111111111111111111111111111111111111111111111100/
0011111111111111111111111111111111111111111111111111111115111111111111111111111111111111111111111111111111111111100/
0011111111111111111111111111111111111111111111111111111115111111111111111111111111111111111111111111111111111111100/
0011111111111111111111111111111111111111111111111111111115111111111111111111111111111111111111111111111111111111100/
0011111111111111111111111111111111111111111111111111111111111111111111111111111111111111111111111111111111111111100/
0011111111111111111111111111111111111111111111111111111115111111111111111111111111111111111111111111111111111111100/
0011111111111111111111111111111111111111111111111111111115111111111111111111111111111111111111111111111111111111100/
0011111111111111111111111111111111111111111111111111111115111111111111111111111111111111111111111111111111111111100/
0011111111111111111111111111111111111111111111111111111111111111111111111111111111111111111111111111111111111111100/
0011111111111111111111111111111111111111111111111111111115111111111111111111111111111111111111111111111111111111100/
0011111111111111111111111111111111111111111111111111111115111111111111111111111111111111111111111111111111111111100/
0011111111111111111111111111111111111111111111111111111115111111111111111111111111111111111111111111111111111111100/
0011111111111111111111111111111111111111111111111111111115111111111111111111111111111111111111111111111111111111100/
0011111111111111111111111111111111111111111111111111111111111111111111111111111111111111111111111111111111111111100/
0011111111111111111111111111111111111111111111111111111115111111111111111111111111111111111111111111111111111111100/
0011111111111111111111111111111111111111111111111111111115111111111111111111111111111111111111111111111111111111100/
0011111111111111111111111111111111111111111111111111111115111111111111111111111111111111111111111111111111111111100/
0011111111111111111111111111111111111111111111111111111111111111111111111111111111111111111111111111111111111111100/
0011111111111111111111111111111111111111111111111111111115111111111111111111111111111111111111111111111111111111100/
0011111111111111111111111111111111111111111111111111111115111111111111111111111111111111111111111111111111111111100/
0011111111111111111111111111111111111111111111111111111115111111111111111111111111111111111111111111111111111111100/
0011111111111111111111111111111111111111111111111111111111111111111111111111111111111111111111111111111111111111100/
0011111111111111111111111111111111111111111111111111111115111111111111111111111111111111111111111111111111111111100/
0011111111111111111111111111111111111111111111111111111115111111111111111111111111111111111111111111111111111111100/
0011111111111111111111111111111111111111111111111111111115111111111111111111111111111111111111111111111111111111100/
0011111111111111111111111111111111111111111111111111111111111111111111111111111111111111111111111111111111111111100/
0011111111111111111111111111111111111111111111111111111115111111111111111111111111111111111111111111111111111111100/
0011111111111111111111111111111111111111111111111111111115111111111111111111111111111111111111111111111111111111100/
0011111111111111111111111111111111111111111111111111111115111111111111111111111111111111111111111111111111111111100/
0011111111111111111111111111111111111111111111111111111111111111111111111111111111111111111111111111111111111111100/
0011111111111111111111111111111111111111111111111111111115111111111111111111111111111111111111111111111111111111100/
0011111111111111111111111111111111111111111111111111111115111111111111111111111111111111111111111111111111111111100/
0011111111111111111111111111111111111111111111111111111115111111111111111111111111111111111111111111111111111111100/
0011111111111111111111111111111111111111111111111111111111111111111111111111111111111111111111111111111111111111100/
0011111111111111111111111111111111111111111111111111111115111111111111111111111111111111111111111111111111111111100/
0011111111111111111111111111111111111111111111111111111115111111111111111111111111111111111111111111111111111111100/
0011111111111111111111111111111111111111111111111111111115111111111111111111111111111111111111111111111111111111100/
0011111111111111111111111111111111111111111111111111111111111111111111111111111111111111111111111111111111111111100/
0011111111111111111111111111111111111111111111111111111115111111111111111111111111111111111111111111111111111111100/
0011111111111111111111111111111111111111111111111111111115111111111111111111111111111111111111111111111111111111100/
0011111111111111111111111111111111111111111111111111111115111111111111111111111111111111111111111111111111111111100/
0011111111111111111111111111111111111111111111111111111111111111111111111111111111111111111111111111111111111111100/
0011111111111111111111111111111111111111111111111111111115111111111111111111111111111111111111111111111111111111100/
0011111111111111111111111111111111111111111111111111111115111111111111111111111111111111111111111111111111111111100/
0011111111111111111111111111111111111111111111111111111115111111111111111111111111111111111111111111111111111111100/
0011111111111111111111111111111111111111111111111111111111111111111111111111111111111111111111111111111111111111100/
0011111111111111111111111111111111111111111111111111111115111111111111111111111111111111111111111111111111111111100/
0011111111111111111111111111111111111111111111111111111115111111111111111111111111111111111111111111111111111111100/
0011111111111111111111111111111111111111111111111111111115111111111111111111111114111111111111111111111111111111100/
0011111111111111111111111111111111111111111111111111111111111111111111111111111111111111111111111111111111111111100/
0011111111111111111111111111111111111111111111111111111115111111111111111111111111111111111111111111111111111111100/
0011111111111111111111111111111111111111111111111111111115111111111111111111111111111111111111111111111111111111100/
0011111111111111111111111111111111111111111111111111111115111111111111111111111111111111111111111111111111111111100/
0011111111111111111111111111111111111111111111111111111115111111111111111111111111111111111111111111111111111111100/
0066666666666666666666666666666666666666666666666666666666666666666666666666666666666666666666666666666666666666600/

