0011111111111111111111111111111111111111111111111111111111111111111111111111111111111111111111111111111111111111100/
0011111111111111111111111111111111111111111111111111111111111111111111111111111111111111111111111111111111111111100/
0011111111111111111111111111111111111111111111111111111111111111111111111111111111111111111111111111111111111111100/
0011111111111211121222222121112111211222221112111112111211111111111111111111111111111111111111111111111111111111100/
0011111111111221121211111121112111211211111121211121212121111111111111111111111111111111111111111111111111111111100/
0011111111111212121222222112121212111212221122211121212121111111111111111111111111111111111111111111111111111111100/
0011111111111211221211111112121212111211121211121211121112111111111111111111111111111111111111111111111111111111100/
0011111111111211121222222111211121111222221211121211121112111111111111111111111111111111111111111111111111111111100/
0011111111111111111111111111111111111111111111111111111111111111111111111111111111111111111111111111111111111111100/
0011111111111111111111111111111111111111111111111111111111111111111111111111111111111111111111111111111111111111100/
0011111111111111111111111111111111111111111111111111111111111111111111111111111111111111111111111111111111111111100/
0011111111111111111111111111111111111111111111111111111111111111111111111111111111111111111111111111111111111111100/
0011111111111111111111111111111111111111111111111111111111111111111111111111111111111111111111111111111111111111100/
0011111111111111111111111111111111111111111111111111111111111111111111111111111111111111111111111111111111111111100/
0011111111111111111111111111111111111111111111111111111111111111111111111111111111111111111111111111111111111111100/
0011111111111111111111111111111111111111111111111111111111111111111111111111111111111111111111111111111111111111100/
0011111111111111111111111111111111111111111111111111111111111111111111111111111111111111111111111111111111111111100/
0011111111111111111111111111111111111111111111111111111111111111111111111111111111111111111111111111111111111111100/
0011111111111111111111111111111111111111111111111111111111111111111111111111111111111111111111111111111111111111100/
0011111111111111111111111111111111111111111111111111111111111111111111111111111111111111111111111111111111111111100/
0011111111111111111111111111111111111111111111111111111111111111111111111111111111111111111111111111111111111111100/
0011111111111111111111111111111111111111111111111111111111111111111111111111111111111111111111111111111111111111100/
0011111111111111111111111111111111111111111111111111111111111111111111111111111111111111111111111111111111111111100/
0011111111111111111111111111111111111111111111111111111111111111111111111111111111111111111111111111111111111111100/
0011111111111111111111111111111111111111111111111111111111111111111111111111111111111111111111111111111111111111100/
0011111111111111111111111111111111111111111111111111111111111111111111111111111111111111111111111111111111111111100/
0011111111111111111111111111111111111111111111111111111111111111111111111111111111111111111111111111111111111111100/
0011111111111111111111111111111111111111111111111111111111111111111111111111111111111111111111111111111111111111100/
0011111111111111111111111111111111111111111111111111111111111111111111111111111111111111111111111111111111111111100/
0011111111111111111111111111111111111111111111111111111111111111111111111111111111111111111111111111111111111111100/
0011111111111111111111111111111111111111111111111111111111111111111111111111111111111111111111111111111111111111100/
0011111111111111111111111111111111111111111111111111111111111111111111111111111111111111111111111111111111111111100/
0011111111111111111111111111111111111111111111111111111111111111111111111111111111111111111111111111111111111111100/
0011111111111111111111111111111111111111111111111111111111111111111111111111111111111111111111111111111111111111100/
0011111111111111111111111111111111111111111111111111111111111111111111111111111111111111111111111111111111111111100/
0011111111111111111111111111111111111111111111111111111111111111111111111111111111111111111111111111111111111111100/
0011111111111111111111111111111111111111111111111111111111111111111111111111111111111111111111111111111111111111100/
0011111111111111111111111111111111111111111111111111111111111111111111111111111111111111111111111111111111111111100/
0011111111111111111111111111111111111111111111111111111111111111111111111111111111111111111111111111111111111111100/
0011111111111111111111111111111111111111111111111111111111111111111111111111111111111111111111111111111111111111100/
0011111111111111111111111111111111111111111111111111111111111111111111111111111111111111111111111111111111111111100/
0011111111111111111111111111111111111111111111111111111111111111111111111111111111111111111111111111111111111111100/
0011111111111111111111111111111111111111111111111111111111111111111111111111111111111111111111111111111111111111100/
0011111111111111111111111111111111111111111111111111111111111111111111111111111111111111111111111111111111111111100/
0011111111111111111111111111111111111111111111111111111111111111111111111111111111111111111111111111111111111111100/
0011111111111111111111111111111111111111111111111111111111111111111111111111111111111111111111111111111111111111100/
0011111111111111111111111111111111111111111111111111111111111111111111111111111111111111111111111111111111111111100/
0011111111111111111111111111111111111111111111111111111111111111111111111111111111111111111111111111111111111111100/
0011111111111111111111111111111111111111111111111111111111111111111111111111111111111111111111111111111111111111100/
0011111111111111111111111111111111111111111111111111111111111111111111111111111111111111111111111111111111111111100/
0011111111111111111111111111111111111111111111111111111111111111111111111111111111111111111111111111111111111111100/
0011111111111111111111111111111111111111111111111111111111111111111111111111111111111111111111111111111111111111100/
0011111111111111111111111111111111111111111111111111111111111111111111111111111111111111111111111111111111111111100/
0011111111111111111111111111111111111111111111111111111111111111111111111111111111111111111111111111111111111111100/
0011111111111111111111111111111111111111111111111111111111111111111111111111111111111111111111111111111111111111100/
0011111111111111111111111111111111111111111111111111111111111111111111111111111111111111111111111111111111111111100/
0011111111111111111111111111111111111111111111111111111111111111111111111111111111111111111111111111111111111111100/
0011111111111111111111111111111111111111111111111111111111111111111111111111111111111111111111111111111111111111100/
0011111111111111111111111111111111111111111111111111111111111111111111111111111111111111111111111111111111111111100/
0011111111111111111111111111111111111111111111111111111111111111111111111111111111111111111111111111111111111111100/
0011111111111111111111111111111111111111111111111111111111111111111111111111111111111111111111111111111111111111100/
0011111111111111111111111111111111111111111111111111111111111111111111111111111111111111111111111111111111111111100/
0011111111111111111111111111111111111111111111111111111111111111111111111111111111111111111111111111111111111111100/
0011111111111111111111111111111111111111111111111111111111111111111111111111111111111111111111111111111111111111100/
0011111111111111111111111111111111111111111111111111111111111111111111111111111111111111111111111111111111111111100/
0011111111111111111111111111111111111111111111111111111111111111111111111111111111111111111111111111111111111111100/
0011111111111111111111111111111111111111111111111111111111111111111111111111111111111111111111111111111111111111100/
0011111111111111111111111111111111111111111111111111111111111111111111111111111111111111111111111111111111111111100/
0011111111111111111111111111111111111111111111111111111111111111111111111111111111111111111111111111111111111111100/
0011111111111111111111111111111111111111111111111111111111111111111111111111111111111111111111111111111111111111100/
0011111111111111111111111111111111111111111111111111111111111111111111111111111111111111111111111111111111111111100/
0011111111111111111111111111111111111111111111111111111111111111111111111111111111111111111111111111111111111111100/
0011111111111111111111111111111111111111111111111111111111111111111111111111111111111111111111111111111111111111100/
0011111111111111111111111111111111111111111111111111111111111111111111111111111111111111111111111111111111111111100/
0011111111111111111111111111111111111111111111111111111111111111111111111111111111111111111111111111111111111111100/
0011111111111111111111111111111111111111111111111111111111111111111111111111111111111111111111111111111111111111100/
0011111111111111111111111111111111111111111111111111111111111111111111111111111111111111111111111111111111111111100/
0011111111111111111111111111111111111111111111111111111111111111111111111111111111111111111111111111111111111111100/
0011111111111111111111111111111111111111111111111111111111111111111111111111111111111111111111111111111111111111100/
0011111111111111111111111111111111111111111111111111111111111111111111111111111111111111111111111111111111111111100/
0011111111111111111111111111111111111111111111111111111111111111111111111111111111111111111111111111111111111111100/
0011111111111111111111111111111111111111111111111111111111111111111111111111111111111111111111111111111111111111100/
0011111111111111111111111111111111111111111111111111111111111111111111111111111111111111111111111111111111111111100/
0011111111111111111111111111111111111111111111111111111111111111111111111111111111111111111111111111111111111111100/
0011111111111111111111111111111111111111111111111111111111111111111111111111111111111111111111111111111111111111100/
0011111111111111111111111111111111111111111111111111111111111111111111111111111111111111111111111111111111111111100/
0011111111111111111111111111111111111111111111111111111111111111111111111111111111111111111111111111111111111111100/
0011111111111111111111111111111111111111111111111111111111111111111111111111111111111111111111111111111111111111100/
0011111111111111111111111111111111111111111111111111111111111111111111111111111111111111111111111111111111111111100/
0011111111111111111111111111111111111111111111111111111111111111111111111111111111111111111111111111111111111111100/



