0000211111111111111111111111111111111111111111111111111115111111111111111111111111111111111111111111111111111120000/
0000211111111111111111111111111111111111111111111111111115111111111111111111111111111111111111111111111111111120000/
0000211111111111111111111111111111111111111111111111111115111111111111111111111111111111111111111111111111111120000/
0000211111111111111111111111111111111111111111111111111111111111111111111111111111111111111111111111111111111120000/
0000211111111111111111111111111111111111111111111111111115111111111111111111111111111111111111111111111111111120000/
0000211111111111111111111111111111111111111111111111111115111111111111111111111111111111111111111111111111111120000/
0000211111111111111111111111111111111111111111111111111115111111111111111111111111111111111111111111111111111120000/
0000211111111111111111111111111111111111111111111111111111111111111111111111111111111111111111111111111111111120000/
0000211111111111111111111111111111111111111111111111111115111111111111111111111111111111111111111111111111111120000/
0000211111111111111111111111111111111111111111111111111115111111111111111111111111111111111111111111111111111120000/
0000211111111111111111111111111111111111111111111111111115111111111111111111111111111111111111111111111111111120000/
0000211111111111111111111111111111111111111111111111111111111111111111111111111111111111111111111111111111111120000/
0000211111111111111111111111111111111111111111111111111115111111111111111111111111111111111111111111111111111120000/
0000211111111111111111111111111111111111111111111111111115111111111111111111111111111111111111111111111111111120000/
0000211111111111111111111111111111111111111111111111111115111111111111111111111111111111111111111111111111111120000/
0000211111111111111111111111111111111111111111111111111111111111111111111111111111111111111111111111111111111120000/
0000211111111111111111111111111111111111111111111111111115111111111111111111111111111111111111111111111111111120000/
0000211111111111111111111111111111111111111111111111111115111111111111111111111111111111111111111111111111111120000/
0000211111111111111111111111111111111111111111111111111115111111111111111111111111111111111111111111111111111120000/
0000211111111111111111111111111111111111111111111111111111111111111111111111111111111111111111111111111111111120000/
0000211111111111111111111111111111111111111111111111111115111111111111111111111111111111111111111111111111111120000/
0000211111111111111111111111111111111111111111111111111115111111111111111111111111111111111111111111111111111120000/
0000211111111111111111111111111111111111111111111111111115111111111111111111111111111111111111111111111111111120000/
0000211111111111111111111111111111111111111111111111111111111111111111111111111111111111111111111111111111111120000/
0000211111111111111111111111111111111111111111111111111115111111111111111111111111111111111111111111111111111120000/
0000211111111111111111111111111111111111111111111111111115111111111111111111111111111111111111111111111111111120000/
0000211111111111111111111111111111111111111111111111111115111111111111111111111111111111111111111111111111111120000/
0000211111111111111111111111111111111111111111111111111111111111111111111111111111111111111111111111111111111120000/
0000211111111111111111111111111111111111111111111111111115111111111111111111111111111111111111111111111111111120000/
0000211111111111111111111111111111111111111111111111111115111111111111111111111111111111111111111111111111111120000/
0000211111111111111111111111111111111111111111111111111115111111111111111111111111111111111111111111111111111120000/
0000211111111111111111111111111111111111111111111111111111111111111111111111111111111111111111111111111111111120000/
0000211111111111111111111111111111111111111111111111111115111111111111111111111111111111111111111111111111111120000/
0000211111111111111111111111111111111111111111111111111115111111111111111111111111111111111111111111111111111120000/
0000211111111111111111111111111111111111111111111111111115111111111111111111111111111111111111111111111111111120000/
0000211111111111111111111111111111111111111111111111111111111111111111111111111111111111111111111111111111111120000/
0000211111111111111111111111111111111111111111111111111115111111111111111111111111111111111111111111111111111120000/
0000211111111111111111111111111111111111111111111111111115111111111111111111111111111111111111111111111111111120000/
0000211111111111111111111111111111111111111111111111111115111111111111111111111111111111111111111111111111111120000/
0000211111111111111111111111111111111111111111111111111111111111111111111111111111111111111111111111111111111120000/
0000211111111111111111111111111111111111111111111111111115111111111111111111111111111111111111111111111111111120000/
0000211111111111111111111111111111111111111111111111111115111111111111111111111111111111111111111111111111111120000/
0000211111111111111111111111111111111111111111111111111115111111111111111111111111111111111111111111111111111120000/
0000211111111111111111111111111111111111111111111111111111111111111111111111111111111111111111111111111111111120000/
0000211111111111111111111111111111111111111111111111111115111111111111111111111111111111111111111111111111111120000/
0000211111111111111111111111111111111111111111111111111115111111111111111111111111111111111111111111111111111120000/
0000211111111111111111111111111111111111111111111111111115111111111111111111111111111111111111111111111111111120000/
0000211111111111111111111111111111111111111111111111111111111111111111111111111111111111111111111111111111111120000/
0000211111111111111111111111111111111111111111111111111115111111111111111111111111111111111111111111111111111120000/
0000211111111111111111111111111111111111111111111111111115111111111111111111111111111111111111111111111111111120000/
0000211111111111111111111111111111111111111111111111111115111111111111111111111111111111111111111111111111111120000/
0000211111111111111111111111111111111111111111111111111111111111111111111111111111111111111111111111111111111120000/
0000211111111111111111111111111111111111111111111111111115111111111111111111111111111111111111111111111111111120000/
0000211111111111111111111111111111111111111111111111111115111111111111111111111111111111111111111111111111111120000/
0000211111111111111111111111111111111111111111111111111115111111111111111111111111111111111111111111111111111120000/
0000211111111111111111111111111111111111111111111111111111111111111111111111111111111111111111111111111111111120000/
0000211111111111111111111111111111111111111111111111111115111111111111111111111111111111111111111111111111111120000/
0000211111111111111111111111111111111111111111111111111115111111111111111111111111111111111111111111111111111120000/
0000211111111111111111111111111111111111111111111111111115111111111111111111111111111111111111111111111111111120000/
0000211111111111111111111111111111111111111111111111111111111111111111111111111111111111111111111111111111111120000/
0000211111111111111111111111111111111111111111111111111115111111111111111111111111111111111111111111111111111120000/
0000211111111111111111111111111111111111111111111111111115111111111111111111111111111111111111111111111111111120000/
0000211111111111111111111111111111111111111111111111111115111111111111111111111111111111111111111111111111111120000/
0000211111111111111111111111111111111111111111111111111111111111111111111111111111111111111111111111111111111120000/
0000211111111111111111111111111111111111111111111111111115111111111111111111111111111111111111111111111111111120000/
0000211111111111111111111111111111111111111111111111111115111111111111111111111111111111111111111111111111111120000/
0000211111111111111111111111111111111111111111111111111115111111111111111111111111111111111111111111111111111120000/
0000211111111111111111111111111111111111111111111111111111111111111111111111111111111111111111111111111111111120000/
0000211111111111111111111111111111111111111111111111111115111111111111111111111111111111111111111111111111111120000/
0000211111111111111111111111111111111111111111111111111115111111111111111111111111111111111111111111111111111120000/
0000211111111111111111111111111111111111111111111111111115111111111111111111111111111111111111111111111111111120000/
0000211111111111111111111111111111111111111111111111111111111111111111111111111111111111111111111111111111111120000/
0000211111111111111111111111111111111111111111111111111115111111111111111111111111111111111111111111111111111120000/
0000211111111111111111111111111111111111111111111111111115111111111111111111111111111111111111111111111111111120000/
0000211111111111111111111111111111111111111111111111111115111111111111111111111111111111111111111111111111111120000/
0000211111111111111111111111111111111111111111111111111111111111111111111111111111111111111111111111111111111120000/
0000211111111111111111111111111111111111111111111111111115111111111111111111111111111111111111111111111111111120000/
0000211111111111111111111111111111111111111111111111111115111111111111111111111111111111111111111111111111111120000/
0000211111111111111111111111111111111111111111111111111115111111111111111111111111111111111111111111111111111120000/
0000211111111111111111111111111111111111111111111111111111111111111111111111111111111111111111111111111111111120000/
0000211111111111111111111111111111111111111111111111111115111111111111111111111111111111111111111111111111111120000/
0000211111111111111111111111111111111111111111111111111115111111111111111111111111111111111111111111111111111120000/
0000211111111111111111111111111111111111111111111111111115111111111111111111111111111111111111111111111111111120000/
0000211111111111111111111111111111111111111111111111111111111111111111111111111114111111111111111111111111111120000/
0000211111111111111111111111111111111111111111111111111115111111111111111111111111111111111111111111111111111120000/
0000211111111111111111111111111111111111111111111111111115111111111111111111111111111111111111111111111111111120000/
0000211111111111111111111111111111111111111111111111111115111111111111111111111111111111111111111111111111111120000/
0000211111111111111111111111111111111111111111111111111111111111111111111111111111111111111111111111111111111120000/
0000211111111111111111111111111111111111111111111111111115111111111111111111111111111111111111111111111111111120000/
0000266666666666666666666666666666666666666666666666666666666666666666666666666666666666666666666666666666666620000/

